Item Metadata for: http://libcdm1.uncg.edu/cdm/ref/collection/RAS/id/469
Headline: 25 dollars reward
Publishing newspaper: Wilmington, N.C. : Wilmington Gazette
Date of advertisement: 1807-02-03
Page: 3
Time period (decade): 1800-1809
Person placing ad: James Williams
Date of departure: 1806-12-24
County of residence: Duplin County (N.C.)
Presumed or intended destination: Wilmington (N.C.)
Slave name(s): Emery
Slaveholder: James Williams
Former slaveholder: William M'Gee;John Taylor
Transcript: 20 Dollars Reward.<BR>Proclamation of Outlawry.<BR>State of North Carolina,<BR>Onslow County.<BR>BY Christopher Dudley and John Spicer, Esquires, two of the Justices of the Peace for the said County.<BR>Whereas complaint hath been this day made to us, by John Fullwood of the said County, that a certain Negro Slave belonging to him, named CUFF, hath absented himself from his said master's service, and is lurking about in the County, committing many acts of felony.<BR>These are therefore, in the name of the state, to command the said slave Cuff forthwith to surrender himself and return home to his said master. And we do hereby also require the Sheriff of the said county of Onslow, to make diligent search and pursuit after the above mentioned slave, and him having found, to apprehend and secure so that he may be conveyed to his said master, or otherwise discharged as the law directs. And the said Sheriff is hereby empowered to raise and take with him such power of his county as he shall think fit, for apprehending the said slave. And we do hereby by virtue of an Act of Assembly of this state concerning servants and slaves, intimate and declare, if the said slave Cuff does not surrender himself and return home, immediatley after the publication of these presents, that any person may kill and destroy the said slave, by such means as he or they may think fit, without accusation or impeachment of any crime or offence for so doing, or without incurring any penalty or forfeiture thereby.<BR>Given under our hands and seals this 22nd day of January 1807, and in the 31st year of the independence of the said state.<BR>Christopher  Dudley, (Seal)<BR>John Spicer, (Seal)
Subject headings: Fugitive slaves--North Carolina--History--Sources;Slavery--North Carolina--History--Sources;Plantation life--North Carolina--History--Sources;North Carolina--History--1775-1865--Sources
Type: Text
Original format: clippings;advertisements
Language: en
Source collection: North Carolina Runaway Slave Advertisements Digital Collection
Collection home page: http://libcdm1.uncg.edu/cdm/landingpage/collection/RAS
Rights statement: http://rightsstatements.org/vocab/NoC-US/1.0/
Additional rights information: NO COPYRIGHT - UNITED STATES. This item has been determined to be free of copyright restrictions in the United States. The user is responsible for determing actual copyright status for any reuse of the material.
Microfilm #: 248
Microfilm Roll: 7
Object ID: 02480701-1807-02-03-03
Date digitized: 2011
Digital master format: Image/tiff
Digital access format: Image/jp2
Digital publisher: The University of North Carolina at Greensboro
Funding source: NC ECHO Digitization Grant administered using LSTA funds through the State Library of North Carolina.
OCLC number: 908772952
