Item Metadata for: http://libcdm1.uncg.edu/cdm/ref/collection/RAS/id/1135
Headline: [Untitled advertisement]
Publishing newspaper: New Bern, N.C. : State Gazette of North Carolina
Date of advertisement: 1788-02-07
Page: 3
Time period (decade): 1780-1789
Person placing ad: Thomas Routledge
Date of departure: 1787-12-26
County of residence: Duplin County (N.C.)
Slave name(s): Dick;Clary
Slaveholder: Thomas Williams
Former slaveholder: Michael Payne, Esq.[Esquire];Governor Johnston
Transcript: Forty Pounds Reward. <BR>  RUN-AWAY from the Subscriber, near Duplin Court-House, on the 26th of December last, TWO NEGROES, a Fellow and a Wench, both of a yellow complexion. The Fellow is about five feet six inches [illegible] well made, speaks plain and loud; carried with him a blue broad cloath coat and jacket, and a pair of leather breeches; he was formerly the property of Michael Payne, Esq.[Esquire] of Edenton, his name is Dick, Virginia born, about 35 years of age, plays on the fiddle. The Wench is called CLARY, of a middle size, but rather fleshy, had a thick under lip and bad teeth, she was the property of the present Governor Johnston; she carried with her a white linen and calico gown, a clouded habit and red cloak, with some homepsun cloaths, she is very handy in any kind of house or needlework, and is about thirty years old. They are both very artful, and it is expected they will attempt to pass as free people and make northwardly. <BR>   Whoever apprehends the said negroes, and secures them in any district jail [illegible] state so that they may be got [illegible] shall be entitled to TWENTY POUNDS REWARD, and if apprehended in any other state and brought home to the above reward. <BR>   Thomas Routledge. <BR>  N.B. All Masters of Vessels and others [illegible] forwarned at their peril [illegible] them out of the state. <BR>   Duplin N.C. Jan. 25, 1788.
Subject headings: Fugitive slaves--North Carolina--History--Sources;Slavery--North Carolina--History--Sources;Plantation life--North Carolina--History--Sources;North Carolina--History--1775-1865--Sources
Type: Text
Original format: clippings;advertisements
Language: en
Source collection: North Carolina Runaway Slave Advertisements Digital Collection
Collection home page: http://libcdm1.uncg.edu/cdm/landingpage/collection/RAS
Rights statement: http://rightsstatements.org/vocab/NoC-US/1.0/
Additional rights information: NO COPYRIGHT - UNITED STATES. This item has been determined to be free of copyright restrictions in the United States. The user is responsible for determing actual copyright status for any reuse of the material.
Microfilm #: 257
Microfilm Roll: 1
Object ID: 02570101-1788-02-07-03-3
Date digitized: 2012
Digital master format: Image/tiff
Digital access format: Image/jp2
Digital publisher: The University of North Carolina at Greensboro
Funding source: NC ECHO Digitization Grant administered using LSTA funds through the State Library of North Carolina.
OCLC number: 908778897
