Item Metadata for: http://libcdm1.uncg.edu/cdm/ref/collection/RAS/id/1352
Headline: Three hundred pound's [sic] reward
Publishing newspaper: Wilmington, N.C. : Cape Fear Mercury
Date of advertisement: 1773-01-13
Page: 1
Time period (decade): 1770-1779
Person placing ad: John Gaillard
Place of residence: St. Stephen's Parish, (S.C.)
Coordinates: 33.405024,-79.923365
Presumed or intended destination: North Carolina;Virginia;Maryland
Slave name(s): Will;George;Sylvia
Slaveholder: John Gaillard
Transcript: Three Hundred Pound's Reward. <BR> St. Stephen's Parish, (in South Carolina)<BR>  RUN AWAY from the Subscriber about Fifteen Months since, Two Negro Fellows and a Wench, viz. WILL, GEORGE, and SYLVIA. WILL, is about Twenty-five Years of Age, Five Feet Eight Inches high, of a yellowish Complexion, slim made, and a little knock-knee'd, his Teeth filed, and his Country marks in his Face; a Cooper and Rough Carpenter: GEORGE is Twenty Years of Age Five Feet Five Inches high, of a dark Complexion, is very artful; he has been used to take Care of Horses: SYLVIA, is a likely young Wench, about Five Feet Five Inches High, of a yellowish Complexion, her Teeth filed; she has attended in a House.  A Reward of ONE HUNDRED and FIFTY POUNDS, Currency, will be paid on Delivery of the above NEGROES to the WARDEN of the Work-House, or at his Plantation in St. Stephen's Parish, near Murray's Ferry, or in Proportion for one, if taken in the Province. <BR>  THOMAS WEST, An Overseer, about twenty five years of age, five feeet[sic] seven inches high, very slim of a swarthy Complection, who lived at the Subscriber's Plantation and about three years, and just about the time the said three Negroes Run-away, he left him: It is generally thought the said Thomas West has carried the Negroes into North-Carolina, Virginia or Maryland, and may offer them for sale. All persons are hereby cautioned not to purchase the said Negroes and if purchased by any Person, they are hereby required to deliver the said Slaves to the Proprietor, or they may depend on being prosecuted to the utmost rigour of the Law. A Reward of three hundred Pounds, currency, will be paid on delivery of the Negroes on in proportion, if taken  out of the Province; and a further Reward of [illegible] hundred Pounds, will be given to whoever will give information of their being carried out of the Province, or being harboured by a white Person, on conviction of the Offender. <BR>  JOHN GALLARD.
Subject headings: Fugitive slaves--North Carolina--History--Sources;Slavery--North Carolina--History--Sources;Plantation life--North Carolina--History--Sources;North Carolina--History--1775-1865--Sources
Type: Text
Original format: clippings;advertisements
Language: en
Source collection: North Carolina Runaway Slave Advertisements Digital Collection
Collection home page: http://libcdm1.uncg.edu/cdm/landingpage/collection/RAS
Rights statement: http://rightsstatements.org/vocab/NoC-US/1.0/
Additional rights information: NO COPYRIGHT - UNITED STATES. This item has been determined to be free of copyright restrictions in the United States. The user is responsible for determing actual copyright status for any reuse of the material.
Microfilm #: 248
Microfilm Roll: 5
Object ID: 02480501-1773-01-13-01-1
Date digitized: 2011
Digital master format: Image/tiff
Digital access format: Image/jp2
Digital publisher: The University of North Carolina at Greensboro
Funding source: NC ECHO Digitization Grant administered using LSTA funds through the State Library of North Carolina.
OCLC number: 908783855
