Item Metadata for: http://libcdm1.uncg.edu/cdm/ref/collection/RAS/id/1192
Headline: [Untitled advertisement]
Publishing newspaper: New Bern, N.C. : North Carolina Gazette
Date of advertisement: 1778-03-13
Page: 3
Time period (decade): 1770-1779
Person placing ad: Wilson Blount
County of residence: Craven County (N.C.)
Place of residence: New Bern (N.C.)
Coordinates: 35.092858,-77.071831
Presumed or intended destination: South Carolina;West Indies
Slave name(s): Abraham
Slaveholder: Major David Barron
Former slaveholder: Mr. Isaac Patridge
Transcript: NEWBERN, NORTH-CAROLINA, Feb 26<BR> RUN away from th subscriber, a mulatto man named Abraham, who he lately bought from  from Mr. Isacc Patridge of this place, he is verly likely and well made, near or about six feet high, tolerable good house carpenter and shoemaker, about forty years of age, as any particular description of them, but he has a plenty, therefore make no doubt he will appear well dressed, and have reason to beleive [sic] he has a considerable sum of money with him, he was seen about ten days since on his way to Holly Shelter, in company with a mulatto man named Lewis, belonging to Mrs. Barron, of this town both on horse-back, he was the property of the late Major David Barron, deceased, he is 18 years of age, and about 5 feet 6 inches high, wel set, has black hair which curles naturally, remarkable large eyes, his face is much freckled, he will also appear well dressed, as he has a plenty of clothes and money; it is expected they will both keep together, and am very sure they will chnage their names, and endeavour to pass as freeman, they will make the best of their way for South Carolina, to enter on board some vessel, in order to make their escape to the West-Indies, as Abrahhm [sic] has relations in St. Eustatia. Any person apprehending the said slaves, goal where the owners can get them, shall reward, if taken out of the state two hundred dollars, and if brought here all reasonable expences paid by<BR> WILSON BLOUNT.<BR>N.B. They have been seen on their way to Cross-Creek, and are supposed to be lurking abut that place.
Subject headings: Fugitive slaves--North Carolina--History--Sources;Slavery--North Carolina--History--Sources;Plantation life--North Carolina--History--Sources;North Carolina--History--1775-1865--Sources
Type: Text
Original format: clippings;advertisements
Language: en
Source collection: North Carolina Runaway Slave Advertisements Digital Collection
Collection home page: http://libcdm1.uncg.edu/cdm/landingpage/collection/RAS
Rights statement: http://rightsstatements.org/vocab/NoC-US/1.0/
Additional rights information: NO COPYRIGHT - UNITED STATES. This item has been determined to be free of copyright restrictions in the United States. The user is responsible for determing actual copyright status for any reuse of the material.
Microfilm #: 248
Microfilm Roll: 1
Object ID: 02480106-1778-03-13-03
Date digitized: 2011
Digital master format: Image/tiff
Digital access format: Image/jp2
Digital publisher: The University of North Carolina at Greensboro
Funding source: NC ECHO Digitization Grant administered using LSTA funds through the State Library of North Carolina.
OCLC number: 908780475
