Item Metadata for: http://libcdm1.uncg.edu/cdm/ref/collection/RAS/id/706
Headline: Twenty Five dollars reward
Publishing newspaper: Edenton, N.C. : State Gazette of North Carolina
Date of advertisement: 1791-02-18
Page: 3
Time period (decade): 1790-1799
Person placing ad: Edmund Dunston
Date of departure: 1791-02-05
County of residence: Bertie County (N.C.)
Presumed or intended destination: Virginia;Edenton (N.C.);Washington (N.C.);Tyrell[Tyrrell] County (N.C.)
Slave name(s): Page;Allen;Peg
Slaveholder: Edmund Dunston
Transcript: Twenty Five Dollars Reward<BR>RUN-AWAY from the subscriber living in Cathy Neck, Bertie County, on the fifth of February inst., two negro fellows, PAGE and ALLEN, both born in Sussex County, Virginia; ALLEN is about thirty three years of age, a very black well made fellow, about five feet eight inches high, has a high forehead and his hair grows narrow on the fore part of his head which makes him appear a little bald, and has a scar on his upper lip occasioned by a whip saw, he can work at the ship carpenters business, and is an ingenious cunning fellow, had on when he went away a round short jacket of light coloured cloth, blue broad cloth breeches, white stockings and a felt hat, he has a purple broad cloth coat and two homespun ditto, that he can change his clothes.--PAGE is about thirty three years old, six feet three inches high, well made and of a yellow complexion, a scar on both lips occasioned by a whip saw, had on when he went away a negro cotton jacket and trowsers, a two shirt and felt hat.<BR>Also at the same time run away, a mulatto wench named PEG, about thirty five years old, of common height, remarkably lusty and homely shaped, she had different petticoats, a blue yarn jacket, a dark grounded gown and a gerineto[?] hat, she was born in Chowan County, in this state.--The fellows are acquainted in Virginia, Edenton, Washington, the upper part of Tyrell County, and up Roanoak River, and it is expected they will make for some of those places.  Any person that will apprehend said negroes within fifty miles of my residence, and return them to me or secure them in any gaol that I may have them, shall be entitled to the above reward, and if apprehended over fifty miles distance, or out of the state, shall have fifteen dollars, for each fellow, and seven dollars for the wench, and all reasonable charges paid by<BR>EDMUND DUNSTON.<BR>N.B. All masters of vessels are forbid harbouring or carrying them off at their peril.<BR>Bertie, February 12, 1791.     67 4
Subject headings: Fugitive slaves--North Carolina--History--Sources;Slavery--North Carolina--History--Sources;Plantation life--North Carolina--History--Sources;North Carolina--History--1775-1865--Sources
Type: Text
Original format: clippings;advertisements
Language: en
Source collection: North Carolina Runaway Slave Advertisements Digital Collection
Collection home page: http://libcdm1.uncg.edu/cdm/landingpage/collection/RAS
Rights statement: http://rightsstatements.org/vocab/NoC-US/1.0/
Additional rights information: NO COPYRIGHT - UNITED STATES. This item has been determined to be free of copyright restrictions in the United States. The user is responsible for determing actual copyright status for any reuse of the material.
Microfilm #: 257
Microfilm Roll: 1
Object ID: 02570101-1791-02-18-03
Date digitized: 2011
Digital master format: Image/tiff
Digital access format: Image/jp2
Digital publisher: The University of North Carolina at Greensboro
Funding source: NC ECHO Digitization Grant administered using LSTA funds through the State Library of North Carolina.
OCLC number: 908773746
