Item Metadata for: http://libcdm1.uncg.edu/cdm/ref/collection/RAS/id/1498
Headline: Ran away
Publishing newspaper: Raleigh, N.C. : Raleigh Register and North Carolina Weekly Advertiser
Date of advertisement: 1819-09-03
Page: 3
Time period (decade): 1810-1819
Person placing ad: H. Thomson;John Young
Date of departure: 1819-08-29
County of residence: Orange County (N.C.)
Place of residence: Hillsborough (N.C.)
Coordinates: 36.077903,-79.097979
Presumed or intended destination: Chatham County
Slave name(s): Duncan;Jim
Slaveholder: Jehu Whited [dec.]
Transcript: RAN AWAY <BR>? FROM the Subscribers on Sunday night, the 29th instant, two NEgro Slaves (Mulattoes) by the name of DUNCAN & JIM, the former about twenty-four years of age, and the latter twenty-one, the said NEgroes belong to the estate of Jehu Whited, dec. and are hired by the subscribers. Probably at this time they are lurking in the neighborhood of Haywood, (Chatham County, in this State) for the purpose of taking off along with them their Borother, who is also? a Mulatto (by the name? of Stephen) these Boys having calculated on their freedom from their late Master's will, and feeling disappointed in their expectation, it is therefore believed they will make for some part of the country where freedom is tolerated, and in the mean time pass as free persons of color, as they are determined to effect their freedom is possible.? Duncan [sic] likely, not very stout, about five feet ten inches high; the Boy Jim is sout and likely; about six feet high and has a scar on his neck occasioned by a rising. Any person or persons? who will apprehend the said negroes and deliver them to the Subscribers in Hillsborough, shall be reasonably rewarded, or if taken up out of the state and secured in any Jail, so that the subscribers get them, shall receive a reward of $5 each. <BR>? H. THOMSON, <BR>? JOHN YOUNG. <BR>? Hillsboro', Sept 1. <BR>? It is said these negroes have procured some kind of instrument of writing from a free man of color, by the name of Ephraim Mitchell,? which was? given by the Clerk of the County some time past which they will probably make use of to answer their purpose. <BR>? The Editors of the Petersburg Intelligence, Richmond Enquirer, Columbia Telescope and Georiga Adverstiser will please insert this advertisement once, and send their accounts to H. Thomson, Hillsboro'.
Subject headings: Fugitive slaves--North Carolina--History--Sources;Slavery--North Carolina--History--Sources;Plantation life--North Carolina--History--Sources;North Carolina--History--1775-1865--Sources
Type: Text
Original format: clippings;advertisements
Language: en
Source collection: North Carolina Runaway Slave Advertisements Digital Collection
Collection home page: http://libcdm1.uncg.edu/cdm/landingpage/collection/RAS
Rights statement: http://rightsstatements.org/vocab/NoC-US/1.0/
Additional rights information: NO COPYRIGHT - UNITED STATES. This item has been determined to be free of copyright restrictions in the United States. The user is responsible for determing actual copyright status for any reuse of the material.
Microfilm #: 252
Microfilm Roll: 8
Object ID: 02520801-1819-09-03-03-2
Date digitized: 2011
Digital master format: Image/tiff
Digital access format: Image/jp2
Digital publisher: The University of North Carolina at Greensboro
Funding source: NC ECHO Digitization Grant administered using LSTA funds through the State Library of North Carolina.
OCLC number: 908787344
